###################
#.J.P.#@#.#@#@@...#
#.###.#.#...#####.#
#..@#.#...#.....#.#
#@#.@.#.#.#.#.#.#.#
###.#.#.#@#.#@#...#
#@......#.#.#.#.###
#.###.###@#.#.#...#
#.....#.....#...#@#
#.#######.#####.#.#
#.#@...@#.#.@...#.#
#.###.###...#.###.#
#..@#.#...#.#.#...#
#@#...#.###.#.#.#.#
#####.#.#@#.#...#@#
#@@@#...#.#.#.#####
#.###.###...#...#@#
#.....#...#...#...#
###################