########################
##...#.........#....@.##
##.@.#@........#...@.@##
##...#.@.#.....#...#####
##.@.#..@#.....#......##
##...#####.....#@.#...##
##....@@@#.....#.@#.@.##
##...#######...####...##
##...#@..#@#.....@#...##
##...###.#.#...####...##
##.@...#.#.....JP..@..##
####...#.######...######
#......................#
#..@..@..@..@..@...@...#
#...@@...@..@..@@.@@...#
#...@....@..@..@.@.@...#
#..@......@@...@...@...#
#......................#
#############...########
##....................##
##..####################
##..@@@@@@@@@@@@@@@@@@##
##..@@@@@@@@@@@@@@@@@@##
########################