###################
#J..P.............#
#.#################
#..@..............#
#.................#
#############.##..#
#.........##..##..#
#.######..######..#
#.##@###..##@@##..#
#.....##..##......#
####..##..##..##@.#
#.##..##..##..##..#
#.##......##..##..#
#.##..##..##..##..#
#.##..##......##..#
#.########..#######
#.########..#######
#.##..............#
#.##..##########..#
#.....##.@....##..#
#....@##......##..#
########..##......#
#@........##..##..#
###################