###########################
#J...........#...........P#
#.####.#####.#.#####.####.#
#@####.#####.#.#####.####@#
#.####.#####.#.#####.####.#
#.........................#
#.####.##.#######.##.####.#
#.####.##.#######.##.####.#
#......##....#....##......#
######.#####.#.#####.######
######.#####.#.#####.######
######.#@.........@#.######
######.#.#########.#.######
######.#.#########.#.######
######...#########...######
######.#.#########.#.######
######.#...........#.######
######.#.#########.#.######
######.#.#########.#.######
#@...........#...........@#
#.####.#####.#.#####.####.#
#.####.#####.#.#####.####.#
#...##@......@......@##...#
###.##.##.#######.##.##.###
###.##.##.#######.##.##.###
#......##....#....##......#
#.##########.#.##########.#
#.##########.#.##########.#
#@.......................@#
###########################