#######
#J@.P.#
#.###.#
#.B@#.#
#@#.@.#
#######