####################
#..................#
#..................#
#.J.@@@......@@@.P.#
#..#####....#####..#
#...###......###...#
#..................#
#........@.........#
#........#.........#
#.......###........#
#.......###........#
#..................#
#....@........@....#
#....###....###....#
#......#####.......#
#........@.........#
#..................#
#..................#
####################