###################
#J@@@.#.@@@...#.@.###
#.@@@.#.@@@...#.@...###
#.###########.#####...######
#@....#.......#.......#...@#
#@....@P......@.......@...@#
#####@@@############@@@#####
....##@##          ##@##
.....###            ###